-----e-e-e-----
---e-e-e-e-e---
-e-m-e-m-e-m-e-
-e-e-a-c-a-e-e-
-e-s-a-a-a-s-e-
---e-e-e-e-e---
-----e-e-e-----