-a-a-a-a-a-a-a-
-r-e-r-e-r-e-r-
-m-m-m-m-m-m-m-
-a-e-a-e-a-e-a-
-r-r-r-r-r-r-r-
-r-r-r-r-r-r-r-
-a-a-a-a-a-a-a-