-r-r-r-e-r-r-r-
---a--r-r--a---
-r-e-r-a-r-e-r-
-r-r-r-r-r-r-r-
-e-r-r-r-r-r-e-
-----r-a-r-----
-r-a-r-e-r-a-r-