-r-r-r---r-r-r-
-r-a-r---r-a-r-
-r-r-r-a-r-r-r-
--r--a-r-a--r--
-r-r-r-a-r-r-r-
-r-a-r---r-a-r-
-r-r-r---r-r-r-