---r-r-e-r-r---
-e-r-a-m-a-r-e-
-r-e-r-a-r-e-r-
-r-r---r---r-r-
-e-r-e-m-e-r-e-
-r-r-r-a-r-r-r-
---e-r-a-r-e---