-r-e-r-r-r-e-r-
-e-r-a-r-a-r-e-
-r-r-a-e-a-r-r-
-a---a-r-a---a-
-e-r-a-e-a-r-e-
-e-e-r---r-e-e-
-e-r-r-e-r-r-e-