-e-e-r-r-r-e-e-
-a-r-r-r-r-r-a-
-r-r-r-a-r-r-r-
-r-r-r-m-r-r-r-
-e-r-r-a-r-r-e-
-e-e-r-r-r-e-e-
-e-e-e-a-e-e-e-