-r-r-e-r-e-r-r-
--r--r-r-r--r--
-r-r-a-m-a-r-r-
--r--m-a-m--r--
-r-r-r-m-r-r-r-
--a-r-r-r-a-r--
-r-r-e-r-e-r-r-