-e-r-a-e-a-r-e-
-a-r-e-r-s-e-a-
-r-e-r-e-r-e-r-
-e-r-e-m-e-r-e-
-e-e-e-a-e-e-e-
-a-r-a-r-a-r-a-
-e-e-r-a-r-e-e-