-e-e-e---e-e-e-
-s-m-s-e-s-m-s-
-e-a-e---e-a-e-
---e---e---e---
-e-e-e---e-e-e-
-a-c-a-e-a-c-a-
-e-a-e---e-a-e-
