-a-a-a-a-a-a-a-
-r-c-r-c-r-c-r-
-m-m-m-m-m-m-m-
-c-c-c-c-c-c-c-
-r-r-r-r-r-r-r-
-r-r-r-r-r-r-r-
-a-a-a-a-a-a-a-