-e-e-e-e-e-e-e-
-e-e-s-m-s-e-e-
-e-e-e-a-e-e-e-
-e-m-c-e-c-m-e-
-e-a-e-e-e-a-e-
-e-e-e-m-e-s-e-
-e-e-s-a-s-e-e-
