-r-r-r-e-r-r-r-
---r--r-r--r---
-r-e-r-c-r-e-r-
-r-r-r-r-r-r-r-
-e-r-r-r-r-r-e-
-----r-c-r-----
-r-a-r-e-r-a-r-