-----e-e-e-----
---e-e-e-e-e---
-e-e-e-e-e-e-e-
-e-e-e-m-e-e-e-
-e-e-e-e-e-e-e-
---e-e-e-e-e---
-----e-e-e-----