-r-r-e-r-e-r-r-
--r--r-r-r--r--
-r-r-a-m-a-r-r-
--r--m-c-m--r--
-r-r-r-m-r-r-r-
--c-r-r-r-c-r--
-r-r-e-r-e-r-r-