-r-e-e-e-e-e-r-
-s-e-c-e-s-c-s-
-e-a-r-a-r-a-e-
-e-r-a-r-a-r-e-
-e-e-e-a-e-e-e-
-a-r-s-r-s-r-a-
-e-e-r-s-r-e-e-