-e-e-e-e-e-e-e-
-e-e-e-e-e-e-e-
-e-e-e-a-e-e-e-
-e-e-a-m-a-e-e-
-e-e-e-a-e-e-e-
-e-e-e-e-e-e-e-
-e-a-e-a-e-a-e-