-e-e-e-s-e-e-e-
-e-e-e-e-e-e-e-
-e-e-s-e-s-e-e-
-e-e-a-e-a-e-e-
-e-e-e-e-e-e-e-
-e-s-e-e-e-s-e-
