---r-r-e-r-r---
-e-r-c-m-c-r-e-
-r-e-r-c-r-e-r-
-r-r---r---r-r-
-e-r-e-m-e-r-e-
-r-r-r-c-r-r-r-
---e-r-a-r-e---