-e-r-a-e-a-r-e-
-a-r-c-r-s-c-a-
-r-e-r-c-r-e-r-
-e-r-e-m-e-r-e-
-e-e-e-a-e-e-e-
-a-r-a-r-a-r-a-
-e-e-r-a-r-e-e-