---e-e-e-e---
--e-e-e-e-e--
-e-e-e-e-e-e-
e-e-e-e-e-e-e
e-e-e-c-e-e-e
e-e-e-e-e-e-e
-e-e-e-e-e-e-
--e-e-e-e-e--
---e-e-e-e---