-e-e-e-e-e-e-e-
-e-e-e-e-e-e-e-
-e-e-e-a-e-e-e-
-e-e-a-e-a-e-e-
-e-e-e-a-e-e-e-
-e-e-e-e-e-e-e-
-e-a-e-a-e-a-e-