---e-e-e-e-e---
-s-e-s-e-s-e-s-
-e-a-r-a-r-a-e-
-m-s-a-c-a-s-m-
-e-e-e-a-e-e-e-
-a-c-s-e-s-c-a-
---e-a-e-a-e---